R       27980 1080
NO TEXTURES/eagle.xpm
SO TEXTURES/n.xpm


WE TEXTURES/mossy.xpm

EA            TEXTURES/redbrick.xpm





S        TEXTURES/pillar.xpm
F 220,10,00
C 225,30,0





11 1111
1 0 0 00 1
1020 0 1
11 00N1
111111
