R      2980 1080
SO TEXTURES/eagle.xpm
WE TEXTURES/n.xpm


NO TEXTURES/mossy.xpm

EA            TEXTURES/redbrick.xpm






F 220,10,00
S        TEXTURES/pillar.xpm
C 225,30,0



111111
100001
102101
1100N1
111111

