R      2980 1080
SO TEXTURES/eagle.xpm
WE TEXTURES/n.xpm


NO TEXTURES/mossy.xpm

EA            TEXTURES/redbrick.xpm






F 250  ,   210,  250
S        TEXTURES/pillar.xpm
C 225,30,0



111111
100001
102101
1100N1
111111

