R       27980 1080
NO TEXTURES/eagle.xpm
SO TEXTURES/n.xpm


WE TEXTURES/mossy.xpm

EA            TEXTURES/redbrick.xpm





S        TEXTURES/pillar.xpm
F 20,10,200
C 25,30,0
S


111111
100001
102001
1100E1
111111


