R       27980 1080
NO TEXTURES/eagle.xpm
SO TEXTURES/n.xpm


WE TEXTURES/mossy.xpm

EA            TEXTURES/redbrick.xpm





S        TEXTURES/pillar.xpm
F 220,10,00
C 225,30,0





111111
100001
102001
1100N1
111111


