R       80 80
NO TEXTURES/eagle.xpm
SO TEXTURES/n.xpm


WE TEXTURES/mossy.xpm

EA            TEXTURES/redbrick.xpm





S        TEXTURES/pillar.xpm
F 220,10,00
C 225,30,0





111111
100001
102001
1100E1
111111



